@@@@@@@@@@@@@@@
@.....@.......@
@.@@.@@.@@@@@.@
@....@..@.....@
@@@.@@@.@@@@@@@
@.@.....@.....@
@.@@@@@.@@@@@.@
@.@@..@.@.....@
@..@.@@.@.@@@@@
@@......@.@...@
@..@@@@@@...@.@
@.@@.......@@@@
@....@@@@@@@..@
@.............@
@@@@@@@@@@@@@@@
