@@@@@@@@@@@@@@@
@.....@.......@
@@@.@.@.@.@@..@
@...@...@.@...@
@.@.@.@.@@@@@@@
@.@.@.@...@...@
@@@.@@@@@@@.@@@
@...........@.@
@.@.@@@@@.@@@.@
@.@...@.....@.@
@.@.@@@@@.@.@.@
@.@.....@.@...@
@@@@@.@.@@@@@@@
@.....@.......@
@@@@@@@@@@@@@@@
