@@@@@@@@@@@@@@@@@@@@@
@..............@....@
@.@@@@@@@@@@@@.@....@
@....@.........@....@
@....@@@@..@@@@@@..@@
@....@..@..@........@
@..@@@..@....@@@@@..@
@.......@....@......@
@@@@@@@@@@@@@@..@@@.@
@...............@.@.@
@.@@.@@@@@@@@@@@@.@.@
@.@..@..........@...@
@.@..@....@.....@...@
@.@..@@@@@@..@@@@.@@@
@.@@@@..............@
@......@@@@@@@@@....@
@.@@@@@@.......@@@@.@
@.....@...@....@....@
@.....@@..@....@....@
@.........@....@....@
@@@@@@@@@@@@@@@@@@@@@
