@@@@@@@@@@@@@@@@@@@@@@@@@@@@@@@@@
@...................@....@......@
@...................@....@......@
@...................@....@......@
@...................@....@......@
@....@@@@@@....@@@@@@....@@@@@@.@
@.........@.....................@
@.........@.....................@
@.........@.....................@
@.........@.....................@
@@@@@@@@@@@@@@@@....@....@@@@@@@@
@...................@....@......@
@...................@....@......@
@...................@....@......@
@...................@....@......@
@....@@@@@@@@@@@@@@@@@@@@@....@.@
@.............................@.@
@.............................@.@
@.............................@.@
@.............................@.@
@....@@@@@@@@@@@@@@@@....@@@@@@@@
@.........@....@.........@......@
@.........@....@.........@......@
@.........@....@.........@......@
@.........@....@.........@......@
@....@....@....@@@@@@@@@@@@@@@@.@
@....@....@.....................@
@....@....@.....................@
@....@....@.....................@
@....@....@.....................@
@@@@@@....@@@@@@@@@@@@@@@@....@.@
@.............................@.@
@@@@@@@@@@@@@@@@@@@@@@@@@@@@@@@@@
