@@@@@@@@@@@@@@@@@
@.............@.@
@@@@.@@.@@@@@.@.@
@....@......@...@
@@@.@@@.@@@.@@@.@
@.@.....@...@.@.@
@.@@@@@.@@@@@.@.@
@.@@..@.@.....@.@
@..@.@@.@.@@@@@.@
@@......@.@.@.@@@
@..@@@@@@.@.@...@
@.@@@.......@@.@@
@.....@@@@@@@@.@@
@@@@@.@...@.....@
@...@.@@@.@.@@@.@
@@@.........@...@
@@@@@@@@@@@@@@@@@
